###############################
#                             #
#  x*       ***  *     *  * * #
# # # # # #*# # #*#*# # # # #*#
#ffff        x **  *  *       #
# # # # # # # # # #*# #*# # # #
#*  *      *  *      *        #
# # # # #*# # # #*#*# # # # # #
#*    **  *       *           #
# #*# # # # # # #*# # # # # # #
#                             #
#                             #
###############################