###############################
#   x  h 2   w   *      * * 3x#
#   *   q   ***  *     *  ****#
# # # # # #*# # #*#*# # # # #*#
#fsbf       1x **  *  *       #
# # # # # # # # # #*# #*# # # #
#*  *     5*  *   4  *        #
# # # # #*# # # #*#*# # # # # #
#* 6  **  *       *           #
# #*# # # # # # #*# # # # # # #
#                             #
#                             #
###############################