###############################
#        x                    #
#   *   q   ***  * *   *  ****#
# # # # # #*# # #*#*# #*# # #*#
#                             #
# # # # # # # # # #*# #*# # # #
#*                  66        #
# # # # #*# # # #*#*# #*# # # #
#*               *     *      #
# #*# # # # # # #*# # # # # # #
#  *                          #
#                             #
###############################