###############################
#   x kh 2   w   *      * * 3x#
#   *   q   ***  *     *  ****#
# # # # # #*# # #*#*# # # # #*#
#fsbf       1x **  *  *   7   #
# # # # # # # # # #*# #*# # # #
#*  *     5*  *   4  *    7   #
# # # # #*# # # #*#*# # # # # #
#* 6  **  *       *           #
# #*# # # # # # #*# # # # # # #
#                             #
#                             #
###############################