###############################
#                             #
#   *   q   ***  *     *  ****#
# # # # # #*# # #*#*# # # # #*#
#                             #
# # # # # # # # # #*# #*# # # #
#*                            #
# # # # #*# # # #*#*# # # # # #
#*                            #
# #*# # # # # # #*# # # # # # #
#                             #
#                             #
###############################