###############################
#p     ** *  1 * 2 *  * * *   #
# # # #*# # #*#*# # # #*#*#*# #
#  x*     ***  *  1   * 2 * * #
# # # # # #*# # #*#*# #b# # #*#
#f         x **  *  *   1     #
# # # # # # # # # #*# #*# # # #
#*  *      *  *  2   *        #
#2# # # #*# # # #*#*# # # # # #
#*    **  *       *           #
# #*# # # # # # #*# # # # # # #
#        2  *   *  *     1    #
###############################