###############################
#        x                    #
#   *   q   ***  *     *  ****#
# # # # # #*# # #*#*# # # # #*#
#                    1111     #
# # # # # # # # # #*# #*# # # #
#*                            #
# # # # #*# # # #*#*# # # # # #
#*                            #
# #*# # # # # # #*# # # # # # #
#                             #
#                             #
###############################