###############################
#              3 *  1  *     x#
#   *       ***  *   2 *  * * #
# # # # # #*# # #*#*# # # # #*#
#fsbf        x **  *  *       #
# # # # # # # # # #*# #*# # # #
#*  *      *  *      *        #
# # # # #*# # # #*#*# # # # # #
#*    **  *       *           #
# #*# # # # # # #*# # # # # # #
#                             #
#                             #
###############################