###############################
#       h        *  1  *  *3 x#
#   *       ***  *   2 *  ****#
# # # # # #*# # #*#*# # # # #*#
#fsbf        x **  *  *       #
# # # # # # # # # #*# #*# # # #
#*  *      *  * 4 4  *        #
# # # # #*# # # #*#*# # # # # #
#*    **  *       *           #
# #*# # # # # # #*# # # # # # #
#                             #
#                             #
###############################