###############################
#p     ** *  1 * 2 *  * b * 4 #
# # # #*# # #*#*# # # #*#*#*# #
#  x*     *** 4* *1     2 * * #
# # # # # #*# # #*#*# # # # #*#
#f      2  x **  ****    6    #
# # # # # # # # # #*#*#*# # # #
#*  *     4*  s 1    * 6    4 #
# # # # #*# # # #*#*# # # # # #
#*  2 **  *    4  *   *** *1* #
# #*# # # # # # #*# # #*# # # #
#     ****  *   h  *   *  3   #
###############################