###############################
#       bfs         2         #
#  x*       ***  *     *  * * #
# # # # # #*# # #*#*# # # # #*#
#            x **  *  *       #
# # # # # # # # # #*# #*# # # #
#*  *      *  *      *        #
# # # # #*# # # #*#*# # # # # #
#*    **  *       *           #
# #*# # # # # # #*# # # # # # #
#                             #
#                             #
###############################