###############################
#p    b** *  1 *   *  w 3 4 3 #
# # # #*# # #*#*# # # #w#w#w#w#
#  x*    ****s *   2  **  * *8#
# # # #f# #*# # #*#*#*# # # #*#
#*  b   *  x **  *6 **   5    #
# # # # # # # #s#*#*# #*# # # #
#*  * w    b  * 4 ****     ***#
# # # # #*# # # #*#*# #*#*# # #
#*    **  **  5   ***   4 3   #
# #*# # # # # # #*#*# # # # # #
#         5    *  ***    2   8#
###############################