###############################
#   x kh 2   w   *      * *83x#
#   *   q   ***  *     *  ****#
# # # # # #*# # #*#*# # # # #*#
#fsbf       1x **  *  *   7   #
# # # # # # # # # #*# #*# # # #
#*  *     5*  *   4  *    7   #
# # # # #*# # # #*#*# # # # # #
#* 6  **  *       *           #
# #*# # # # # # #*# # # # # # #
#                        9999 #
#                        9999 #
###############################