###############################
#  wx k      w   *    **3 83 x#
#   *      h***  *  7  * 3  **#
# # # # # #*# # #*#*# #*# # #*#
# f     7    1x **  *  *   78 #
# # # # # # # # # #*# #*#*#*# #
# * * 4   5*  *   4  *   q7 #*#
# # # # #*# # # #*#*# # #####7#
#  1  **  *   7   *  7  # 9 87#
# #*# #*# # # # #*# # # # #9#7#
#  7  2 7       7    7  # 9977#
#   7       7    7      # 9977#
###############################